1111111
1P00111
111C001
1C000E1
1111111
