111111111111111
1P001000C000001
1110100000C1101
1C0000E11111101
1000000C11C0001
111111111111111
